/--------------------------------------------------------------------------------------------------\
|..................................................................................................|
|..................................................................................................|
|.../------------------------------------------------------------------------------------------\...|
|...|..........................................................................................|...|
|...|..........................................................................................|...|
|...|.../----------------------------------------------------------------------------------\...|...|
|...|...|.................................................This is the end of the test maze.|...|...|
|...|...|..................................................................X...............|...|...|
|...|...|.../------------------------------------------------------------------------------|...|...|
|...|...|...\------------------------------------------------------------------------------/...|...|
|...|...|......................................................................................|...|
|...|...|......................................................................................|...|
|...|...\--------------------------------------------------------------------------------------/...|
|...|..............................................................................................|
|.S.|..............................................................................................|
\---/----------------------------------------------------------------------------------------------/
