WWWWWWWWWWWWWWWWWWWWWWWWWWWWWWWWWWWWWWWWWWWWWWWWWWWWWWWWWWWWWWWWWWWWWWWWWWWWWWWWWWWWWWWWWWWWWWWWWWWWWWWWWWWWWWWWWWWWWWWWWWWWWWWWWWWWWWWWWWWWWWWWW
WWWWWWWWWWWWWWWWWWWWWWWWWWWWWWWWWWWWWWWWWWWWWWWWWWWWWWWWWWWWWWWWWWWWWWWWWWWWWWWWWWWWWWWWWWWWWWWWWWWWWWWWWWWWWWWWWWWWWWWWWWWWWWWWWWWWWWWWWWWWWWWWW
WWWWWWWWWWWWWWWWWWWWWWWWWWWWWWWWWWWWWWWWWWWWWWWWWWWWWWWWWWWWWWWWWWWWWWWWWWWWWWWWWWWWWWWWWWWWWWWWWWWWWWWWWWWWWWWWWWWWWWWWWWWWWWWWWWWWWWWWWWWWWWWWW
WWWWWWWWWWWWWWWWWWWWWWWWWWWWWWWWWWWWWWWWWWWWWWWWWWWWWWWWWWWWWWWWWWWWWWWWMMMMMMMMMMMMMMMMMMMMMMMMMMMMMMMWWWWWWWWWWWWWWWWWWWWWWWWWWWWWWWWWWWWWWWWWW
WWWWWWWWWWWWWWWWWWWWWWWWWWWWWWWWWWWWWWWWWWWWWWWWWWWWWWWWWWWWWWWWWWWWWMMMMMMMMMMMMMMMMMMMMMMMMMMMMMMMMMMMMWWWWWWWWWWWWWWWWWWWWWWWWWWWWWWWWWWWWWWWW
WWWWWWWWWWWWWWWWWWWWWWWWWWWWWWWWWWWWWWWWWWWWWWWWWWWWWWWWWWWWWWWWWwMMMMMMMMMMMMMMMMMMMMMMMMMMMMMMMMMMMMMMMMMMMMMMMWWWWWWWWWWWWWWWWWWWWWWWWW...WWWW
WWWWWWWWWWWWWWWWWWWWWWWWWWWWWWWWWWWWWWWWWWWWWWWWWWWWWWWWMMMMMMMMMMMMMMMMMMMMMMMMMMMMMMMMMMMMMMMMMMMMMMMMMMMMMMMMMMMMMMMMMMMWWWWWWWWWWWW........WW
WWWWWWWWWWWWWWWWWWWWWWWWWWWWWWWWWWWWWWWWWWWWWWMMMMMMMMMMMMMMMMMMMMMMMMMMMMMMMMMMMMMMMMMMMMMMMMMMMMMMMMMMMMMMMMMMMMMMMMMMM......................WW
WWWWWWWWWWWWWWWWWWWWWW..MMMMMMMMMMMMMMMMMMMMMMMMMMMMMM...MMMMMMMMMMMM..MMMMMMMMMM...MMMM..........mmmmmmm............................--------.WWW
WWWWWWWWWWWWWWWWWWWWWW....--MMMMMMMMMMMMMMMMMMMMMMMMMMMMMMMMMMMMMMMMMMMMMMMMMMMMMM...MMMM---------MMMMMMMMMMM...Next Level=>.........] Get  |.WWW
WWWWWWWWWWWWWWWWWWWWWW.............MMMMMMMMMMMMMMMMMMMMMMMMMMMMMMMMMMMMMMMMMMMMMMMM......M............MMMMMMMMM......................[ to   |..WW
WWWWWWWWWWWWWWWWWWWWWW..................MMMMMMMMMMMMMMMMMMMMMMMMMMMMMM..MMMM..MM.........................MM..........................| here |..WW
WWWWWWWWWWWWWWWWWWWWWW.............................MMMMMMMMMMMMMMMMM......MM........................................................W| to   |..WW
WWWWWWWWWWWWWWWWWWWWW...................................MM.....................................................................WWWWWW| win  |...W
WWWWWWWWWWWWWWWWWWWWWW..../------------------------------------------------------------|   |---------------------------------\WWWWWWW|------|WWWW
WWWWWWWWWWWWWWWWWwWWWW....|..*..........................*............................|W|   |WWWWWWWWWWWWWWWWWWWWWWWWWWWWWWWWWWWWWWWWWWWWWWWWWWWWW
WWWWWWWWWWWWWWWWWWWWWW....|.............*............................................|W|   |WWWWWWWWWWWWWWWWWWWWWWWWWWWWWWWWWWWWWWWWWWWWWWWWWWWWW
WWWWWWWWWWWWWWWWWWWWWXX...|.../---------------------------------..-------------------|W]___[WWWWWWWWWWWWWWWWWWWWWWWWWWWWW\...|WWWWWWWWWWWWWWWWWWW
WWWWWWWWWWWWWWWWWWWWWWXX..|...|...............*......................................|W|   |WWWWWWWWWWWWWWWWWWWWWWWWWWWWW|...|WWWWWWWWWWWWWWWWWWW
WWWWWWWWWWWWWWWWWWWWWWXX..|...|........****........*.............*****...............|W|   |WWWWWWWWWWWWWWWWWWWWWWWWWWWWW|...|WWWWWWWWWWWWWWWWWWW
WWWWWWWWWWWWWWWWWWWWWWWW..|...|.../----------------------------------------------------|   |-------------------------\WWW|.**|WWWWWWWWWWWWWWWWWWW
WWWWWWWWWWWWWWWWWWWWWWWW..|...|...|..................................................................................|---|...|WWWWWWWWWWWWWWWWWWW
WWWWWWWWWWWWWWWWWWWWWWWW..|...|...|..................................................................X...............|...|...|WWWWWWWWWWWWWWWWWWW
WWWWWWWWWWWWWWWWWWWWWWWW..|...|...|.../------------------------------------------------------------------------------|...|...|WWWWWWWWWWWWWWWWWWW
WWWWWWWWWWWWWWWWWWWWWWWW..|...|...|...\------------------------------------------------------------------------------/...|...|WWWWWWWWWWWWWWWWWWW
WWWWWWWWWWWWWWWWWWWWWWWW..|...|...|......................................................................................|...|WWWWWWWWWWWWWWWWWWW
WWWWWWWWWWWWWWWWWWWWWWWW..|...|...|......................................................................................|...|WWWWWWWWWWWWWWWWWWW
WWWWWWWWWWWWWWWWWWWWWWW...|...|...\-----------------------------------------------------.....----------------------------/...|WWWWWWWWWWWWWWWWWWW
WWWWWWWWWWWWWWWWWWWWWWWWW.|...|................******........................................................................|WWWWWWWWWWWWWWWWWWW
WWWWWWWWWWWWWWWWWWWWWWWWWW|.S.|...........................**.................................................................|WWWWWWWWWWWWWWWWWWW
WWWWWWWWWWWWWWWWWWWWWWWWWW\---/----------------------------------------------------------------------------------------------/WWWWWWWWWWWWWWWWWWW
WWWWWWWWWWWWWWWWWWWWWWWWWWWWWWWWWWWWWWWWWWWWWWWWWWWWWWWWWWWWWWWWWWWWWWWWWWWWWWWWWWWWWWWWWWWWWWWWWWWWWWWWWWWWWWWWWWWWWWWWWWWWWWWWWWWWWWWWWWWWWWWWW
WWWWWWWWWWWWWWWWWWWWWWWWWWWWWWWWWWWWWWWWWWWWWWWWWWWWWWWWWWWWWWWWWWWWWWWWWWWWWWWWWWWWWWWWWWWWWWWWWWWWWWWWWWWWWWWWWWWWWWWWWWWWWWWWWWWWWWWWWWWWWWWWW
WWWWWWWWWWWWWWWWWWWWWWWWWWWWWWWWWWWWWWWWWWWWWWWWWWWWWWWWWWWWWWWWWWWWWWWWWWWWWWWWWWWWWWWWWWWWWWWWWWWWWWWWWWWWWWWWWWWWWWWWWWWWWWWWWWWWWWWWWWWWWWWWW
WWWWWWWWWWWWWWWWWWWWWWWWWWWWWWWWWWWWWWWM...WWWWWWWWWWWWWWWWWWWWWWWWWWWWWWWWWWWWWWWWWWWWWWWWWWWWWWWWWWWWWWWWWWWWWWWWWWWWWWWWWWWWWWWWWWWWWWWWWWWWWW
WWWWWWWWWWWWWWWWWWWWWWWWWWWWWWWWWWWWWWWWW...WWWWWWWW..XXXWWWWWWWWWWWWWWWWWWWWWWWWWWWWWWWWWWWWWWWWWWWWWWWWWWWWWWWWWWWWWWWWWWWWWWWWWWWWWWWWWWWWWWWW
WWWWWWWWWWWWWWWWWWWWWWWWWWWWWWWWWWWWWWWWWW....WWWWWWW.....WWWWWWWWWWWWWWWWWWWWWWWWWWWWWWWWWWWWWWWWWWWWWWWWWWWWWWWWWWWWWWWWWWWWWWWWWWWWWWWWWWWWWWW
WWWWWWWWWWWWWWWWWWWWWWWWWWWWWWWWWWWWWWWWW..WWWWWWWWWWWWWWWWWWWWWWWWWWWWWWWWWWWWWWWWWWWWWWWWWWWWWWWWWWWWWWWWWWWWWWWWWWWWWWWWWWWWWWWWWWWWWWWWWWWWWW
WWWWWWWWWWWWWWWWWWWWWWWWWWWWWWWWWWWWWWWWWWWWWWWWWWWWWWWWWWWWWWWWWWWWWWWWWWWWWWWWWWWWWWWWWWWWWWWWWWWWWWWWWWWWWWWWWWWWWWWWWWWWWWWWWWWWWWWWWWWWWWWWW
WWWWWWWWWWWWWWWWWWWWWWWWWWWWWWWWWWWWWWWWWWWWWWWWWWWWWWWWWWWWWWWWWWWWWWWWWWWWWWWWWWWWWWWWWWWWWWWWWWWWWWWWWWWWWWWWWWWWWWWWWWWWWWWWWWWWWWWWWWWWWWWWW
